der Führerschein - driving license
umziehen - to move, переехать
vorhaben - to plan
genießen - to enjoy
wohl - well, comfortably; probably
der Mitbewohner - roommate
nerven - нервировать, to annoy
die Auswahl - choice, selection
sich entscheiden - to decide, to choose

die Bildungseinrichtung - учебное заведение
die Aufzeichnung - recording
die Ausstattung - equipment, facility
der Hörsaal {Hörsälen} - lecture hall
das Labor - lab, laboratory
die Betreuung - support, supervision, assistance
die Beratung - advice, consulting
vertiefen - to deepen
weltweit - worldwide
der Austausch - exchange, replacement
die Forschung - research, investigation
die Verknüpfung - link, connection
die Verbindung - connection
der Benutzer - user
die Voraussetzung - precondition, requirement
bewerben bewarb beworben - to apply, submit
die Bewerbung - application
rechtzeitig - on time
der Erfolg - success
erfolgreich - successful
der Ausfall - failure, fail
der Bewerber - applicant, candidate
der Arbeitgeber - employer
der Mitarbeiter - employee, der Arbeitnehmer
eignen - to be suitable, suit
geeignet - suitable, appropriate
güngstig - cheap, convenient, favourable
führen - to lead, cause
ausführen - to run, perform, execute
die Öffnung - opening
der Verschluss - die Schließung, closure
der Schritt - step, шаг
die Stelle - place, point, position
passen - to fit, match, suit
der Schwerpunkt - focus, emphasis
liefern - to deliver
die Lieferung - delivery
begrüssen - to welcome, greet, appreciate
der Wert - value, worth
die Anzahl - number
das Phänomen - phenomenon
die Schönheit - beauty
die Angst - fear
aufbrauchen - to consume, deplete, use up
beinhalten - to include, contain, involve
die Kreativität - creativity
wahrscheinlich - probably
herstellen - to produce, make
verbringen - to spend, enjoy
freiwillig - voluntarily
nass - wet
abdecken - to cover
schneiden schnitt geschnitten - to cut
gerade - straight, even, четный
der Körper - body
die Linie - line
aufnehmen - to record, take
benötigen - to require, need
die Reparatur - repair, reparation
die Oberfläche - surface
die Praxis - practice
anstrengent - stressful
die Erklärung - explanation
das Abenteuer - adventure
die Werbung - die Anzeige, advertisement
verbessern - to improve
widmen - to devote, dedicate
einst - once
notwendig - necessary, required
nötig - necessary, needed
ausreichen - to be enough, to be sufficient
die Verzeihung - sorry, извинение
raten - to advise, recommend
die Beratung - advice, der Rat
vorschlagen - to suggest
der Vorschlag - suggestion
empfehlen - to recommend
die Empfehlung - recommendation
wählen - to choose
auswählen - to select
gewinnen - siegen, to win
der Sieg - win, victory
verabreden - to arrange
vorhaben - to plan
speichern - to save, store, keep, retain
hinzufügen - to add
die Nuss {Nüsse} - nut
die Quelle - source
enthalten - to contain
bevorzugen - to prefer
aufstehen - to get up
das Aufstehen - getting up
das Pulver - powder
der Fluss - river, flow
flüssig - liquid, fluid, fluent
verbreiten - to spread, distribute
verbreitet - common, widespread
zwingen - to force, coerce, compel
versuchen - to try, attempt
der Versuch - attempt
aufgeben - to give up
überlegen - to think, consider
die Sorge - worry, concern, anxiety
das Tal - valley
plötzlich - sudden(ly), abrupt(ly)

der Sinn - meaning, sense
sinnvoll - meaningful
die Reihenfolge - order, порядок
der Hinweis - note, hint
verschieben - to postpone
halten - to keep, hold
der Vortrag - lecture, talk, speech
vorbereiten - to prepare
der Atem - breath
rasant - rapid(ly)
der Fortschritt - progress, advance
erzählen - to share, tell
ermöglichen - to allow, provide
der Bildschirm - screen, display
erforden - benötigen, to require
erforderlich - required, necessary, needed
das Haupt - head
umfassen - to include, cover
die Pflicht - obligation, duty
obligatorisch - verbindlich
der Inhalt - content
solid - solid
die Kenntnis - knowledge, understanding
der Schwerpunkt - focus
die Fähigkeit - ability, capability, skill
fähig - capable, able
umfangreich - extensive, broad, substantial
die Kunst - art
künstlich - artificial(ly)
wesentlich - significant(ly), much
neben - außerdem
der Bereich - area, field
die Leidenschaft - passion, love
umfangen - to embrace, surround
die Wahrheit - truth, reality
erbringen - to provide
ausschließen - to exclude, eliminate
gegensitig - each other
zusätzlig - in addition, furthermore
anwenden - to apply, use
abschließen - to complete, finish; to lock
erhalten - to receive, obtain
der Rahmen - frame, рама
regelmäßig - regularly, often
der Begriff - term, concept
das Ereignis - event, occasion
bezeichnen - to refer, describe
beschreiben - bezeichnen, to describe
zeitlich - temporary
begrenzen - to limit, restrict
die Grenze - border, limit, boundary
das Merkmal - feature, characteristic
ausrechnen - to calculate, figure out
aufsetzen - to put on, set up
die Miene - facial expression, мина
das Gesicht - face
das Geheimnis - secret, mystery
der Schnurrbart - mustache
verstellen - to imagine
die Vorstellung - die Fantasie
fürchterlich - furchtbar, schrecklich, schlimm
entgegen - contrary to, against
hingegen - however, on the other hand
merken - вспомнить
überhaupt - at all
die Geduld - patience
kleben - приклеить
der Kleber - glue
irgendwann - at some point, eventually, когда-нибудь
eifrig - eager(ly)
zugehen - to approach, reach, walk up
der Hals - neck, throat
der Schmerz - pain
schmerzhaft - schmerzlich, painful
die Stimme - voice, vote
plaudern - поболтать
immerhin - в конце концов, по крайней мере
zufrieden - довольный, счастливый, content
lächeln - to smile
die Armbanduhr - watch, wrist watch
die Fläche - surface
verwandt - related
die Belohnung - reward
flach - flat
zweidimensional - 2D
dreidimensional - 3D
rund - round; around
der Kreis - circle
die Ecke - corner, edge
das Dreieck - triangle
das Viereck - recktangle, четырехугольник
das Quadrat - квадрат
das Rechteck - rectangle
der Würfel - cube
die Kugel - шар, sphere
der Kegel - cone
der Zylinder - cylinder
bestehen aus - to consist of, include, to be made of
die Pyramide - pyramid
irgendjemand - кто-то
irgendwie - как-то
irgendwo - где-то
irgendwas - irgendetwas, что угодно
nämlich - namely
entdecken - to explore, discover
die Entdeckung - discovery, detection
schüchtern - shy, timid
die Erfahrung - experience
gewöhnen - привыкнуть
allerdings - however, though, trotzdem, obwohl, aber, hingegen
liefern - to deliver
die Lieferung - delivery
die Ampel - светофор, traffic light
anbieten - to offer
das Angebot - offer
anfangen - to begin
der Anfang - beginning
täuschen - to deceive, обмануть
erleben - to experience
der Vorteil - advantage
der Nachteil - disadvantage

der Bruch - fraction
der Zähler - nominator
der Nenner - denominator
vorankommen - to progress, move forward

die Tätigkeit - activity
der Unterschied - difference
trennen - to separate
getrennt - separate
anschließen - join, connect, attach