verschieben - to postpone
zwingen - to force, coerce, compel
versuchen - to try, attempt
aufgeben - to give up
überlegen - to think, consider
bevorzugen - to prefer
speichern - to save, store, keep, retain
verabreden - to arrange
vorhaben - to plan  
wählen - to choose
auswählen - to select
gewinnen - siegen, to win
vorschlagen - to suggest
empfehlen - to recommend
widmen - to devote, dedicate
aufnehmen - to record, take
benötigen - to require, need
abdecken - to cover
schneiden schnitt geschnitten - to cut
herstellen - to produce, make
verbringen - to spend, enjoy
genießen - to enjoy
passen - to fit, match, suit
führen - to lead, cause
umziehen - to move, переехать
halten - to keep, hold
vorbereiten - to prepare
erreichen - to reach
erwarten - to expect
bedeuten - to mean
besuchen - to visit
folgen - to follow
fühlen - to feel
gehören - to belong
lachen - to laugh
reisen - to travel
riechen - to smell
scheinen - to shine
erscheinen - to appear, arise
schaffen - to create
schmecken - to taste
tragen - to carry, wear
treffen - to meet
verbinden - to connect
verlassen - to leave
verlieren - to lose
zählen - to count
ziehen - to pull
atmen - to breathe
teilnehmen - to participate
anbieten - to offer
liefern - to deliver
gewöhnen - привыкнуть
entdechen - to explore, discover
anfangen - to begin
der Anfang - beginning